NO ./textures/north.xpm
SO ./textures/south.xpm
WE ./textures/north.xpm
EA ./textures/north.xpm


F 175,122,197
C 160,232,255 

111111111111111
101         101                                                                       
1011111111  101
1000000001  101
100010000111101 
101111111111101
101         101                                                                       
1011111111  101
1000000001  101
1000100001  101
101111111111101
100000000000001
101111111111001  
101         101                                                                       
1011111111  101
1000000001  101
1000100001  101
101111111111101
100000000000001
101111111111001 
101         101                                                                       
1011111111  101
1000000001  101
1000100001  101
101111111111101 
101         101                                                                       
101111111111101
1E0000000000001
100010000111101
111111111111111
