NO ./textures/
SO ./path_to_the_south_texture
WE ./path_to_the_west_texture
EA ./path_to_the_east_texture


F 220,100,0
C 225,30,0

                                                                                
        111111111       1111111111111111                                      
        100000001           111000000000111                             1111111       
        101100001                11100000000111111                       1011111                        
        100100001            11111000000000001
1111111110110000011        110000000000011111
1000000000110000011      110111111111111
11110111111111011100000010001
11110111111111011101010010001                   
11000000110101011100000010001
10000000000000001100000010001
10000000000000001101010010001
11000001110101011111011110N0111
11110111 1110101 1001111010001
11111111 1111111
C 220,100,110


11111
10N11
11111