NO ./textures/north.xpm
SO ./textures/north.xpm
WE ./textures/north.xpm
EA ./textures/north.xpm


F 175,122,197
C 160,232,255 

11 
101                                                                                
1011111111
1S00000001
1000100001
1111111111