NO ./textures/north.xpm
SO ./textures/south.xpm
WE ./textures/west.xpm
EA ./textures/east.xpm


F 220,100,0
C 225,30,0

                                                                                
11111111111111111111111111111111111111111111111111
10000000000000000000000000000000000000000000000001
1111111111111111111000001111111111111111111100001
1000000000000000001010001000000000000000000100001
1011111111111111101011101111111111111111011100001
1010000000000011101000000000000000000001000000001
1010111111111011101111111111111111111010111111111
1000100000001000000000000000000000000010000000001
1111101111101111111111111111111111111111111111001111111111
10000010000000000000000000000000000000000000010000000000E1
1011111011111111111111111111111111111111111011001111111111  1
1000000010000000000000000000000000000000010000001         10111
1011111010111111111110111111111111111010111111101         10001
1000000010000000000010000000000000010000000000101         11111
1111111111111111111111111111111111111111111111101111111111
1000000000000000000000000000000000000000000000001000000001
10111111111111111111111111111111111111111111111011111111111 
1000000000000000000000000000000000000000000000001
1111111111111111111111111111111111111111111111111