NO ./textures/
SO ./path_to_the_south_texture
WE ./path_to_the_west_texture
EA ./path_to_the_east_texture


F 220,100,0
C 225,30,0

                                                                                
111111111111111111111111111111
11000001110101011111011110N0111
11111111111111111111111111111