NO ./textures/north.xpm
SO ./textures/south.xpm
WE ./textures/west.xpm
EA ./textures/east.xpm


F 220,100,0
C 225,30,0

111
101                                                                                
1011111111
1N00000001
1000100001
1111111111
