NO bonus//textures/south.xpm
SO bonus//textures/south.xpm
WE bonus//textures/south.xpm
EA bonus//textures/south.xpm


F 175,122,197
C 160,232,255 

111111111
100010101
101000101
100N100001
1011011111
1000001
1111111