NO bonus//textures/north.xpm
SO bonus//textures/south.xpm
WE bonus//textures/west.xpm
EA bonus//textures/east.xpm


F 175,122,197
C 160,232,255 

 1111111111
10D0N0D011
1011D111111
10D00000111
1111D10011
11110101011
111111X111
11111111111
11111111111