NO bonus//textures/north.xpm
SO bonus//textures/south.xpm
WE bonus//textures/west.xpm
EA bonus//textures/east.xpm


F 175,122,197
C 160,232,255 

1111111
1001001
100N001
1001001
1111111