NO mandatory//textures/north.xpm
SO mandatory//textures/south.xpm
WE mandatory//textures/west.xpm
EA mandatory//textures/east.xpm


F 175,122,197
C 160,232,255 

111111111111111111111111111111111111111111
1000001000000001000000000000001000000N0001
101110101111110111110111111110101111111101
101000101000000100010100000000101000000101
101011101011110111010101111111101011110101
100010001010010001010101000000001010010101
111110111010111101010101011111111010110101
100000100010100001010101000100000010100101
101110101110101111010101110101111110101101
101000101000100000010100010101000000100001
101110101110111110110111010101111110111101
100010100010000000100001010100000010000001
101110111011111110101111010111111010111111
100000001000000010101000010000001010000001
111111101111110110101011111110101011110101
100000100000010100101010000010101010010101
101110111111010101101010111010101010110101
101000100001010101001010001010101010100101
101011101101010101011010101110101011101101
100010001001010001010010100000101000000001
101110111011011111010110111110101111111101
100000100010010000010100000010100000000001
111111111111111111111111111111111111111111