NO bonus//textures/north.xpm
SO bonus//textures/south.xpm
WE bonus//textures/west.xpm
EA bonus//textures/east.xpm


F 175,122,197
C 160,232,255 

111111111111111111
1N0000000001000011
111111110000100001
1000000000000001111
101111111111110111
1X100000000000011
111111111111111111