NO bonus//textures/north.xpm
SO bonus//textures/south.xpm
WE bonus//textures/west.xpm
EA bonus//textures/east.xpm


F 175,122,197
C 160,232,255 

1111111111111111111111111111111
1N00010000100001000010000100001
101D101110101110110111011101101
1000100D001D101001000D000D00101
1011101110101011011011111111011
1D10101000101011010010010001101
101011101D101011101110101D10101
101D101000010010010000100011011
1000101D100D001001001D101D10101
1011101010111011011010111011011
10000100D001001101101D101001101
101D101110101010101100110101011
1000000000010010010000000000101
1010100011011111011101111111011
1D10100001001000110100010001001
1010111000111011011010111011011
10000101D101000001101D101001001
1111100001111111111110111011111
1000101D100D001001001D101D10001
1011101010111011011010111011001
1000000100101001101010101001101
1011101110101010101101110101011
100X000000010010010001000000101
1111111111111111111111111111111