NO bonus//textures/north.xpm
SO bonus//textures/south.xpm
WE bonus//textures/west.xpm
EA bonus//textures/east.xpm


F 175,122,197
C 160,232,255 

11111111111
1SD0001111
10111111111
1D111111111
101
1X1
111