NO bonus//textures/north.xpm
SO bonus//textures/south.xpm
WE bonus//textures/west.xpm
EA bonus//textures/east.xpm


F 175,122,197
C 160,232,255 

11111111111
10DD001111
1S111111111
1D111111111
1D1
1X1
111