NO bonus//textures/north.xpm
SO bonus//textures/south.xpm
WE bonus//textures/west.xpm
EA bonus//textures/east.xpm


F 175,122,197
C 160,232,255 

11111111111
1N000100001
1D111011101
100D000D001
10111111101
10000010001
11101010111
101D1010D01
101010101D1
100000101X1
11111111111