NO mandatory//textures/north.xpm
SO mandatory//textures/south.xpm
WE mandatory//textures/west.xpm
EA mandatory//textures/east.xpm


F 175,122,197
C 160,232,255 

11111111111111111111111111111111111111111111111111
1N000000000000000000000000000000000000000000000001
10010000010000010000010000010000010000010000010001
10000000000000000000000000000000000000000000000001
10000000000000000000000000000000000000000000000001
10000000000000000000000000000000000000000000000001
10010000010000010000010000010000010000010000010001
10000000000000000000000000000000001100000000000001
1101111111011111110111111101111111 11111101111111
10000000000000000000000000000000001110000000000001
10010000010000010000010000010000010000010000010001 111  111
10000000000000000000000000000000000000000000000001      101
100000000000000000000000000000000000000000000000011     11
10000000000000000000000000000000000000000000000001
10010000010000010000010000010000010000010000010001
10000000000000000000000000000000000000000000000001
11011111110111111101111111011111110111111101111111
10000000000000000000000000000000000000000000000001
10010000010000010000010000010000010000010000010001
10000000000000000000000000000000000000000000000001
10000000000000000000000000000000000000000000000001
10000000000000000000000000000000000000000000000001
10010000010000010000010000010000010000010000010001
10000000000000000000000000000000000000000000000001
11111111111111111111111111111111111111111111111111
