NO bonus//textures/north.xpm
SO bonus//textures/south.xpm
WE bonus//textures/west.xpm
EA bonus//textures/east.xpm


F 175,122,197
C 160,232,255 


11111111111111111111                                                   1
100000000000000000001                                                 101
1111111111111111110001                                               10001
                1000001                                             1000001
               100000001                                           100000001
              10000S00001                                         10000000001
             1000000000001                                       1000000000001
            100000000000001                                     100000000000001
           10000000000000001                                   10000000000000001
          1000000000000000001              111111111111       1000000000000000001
         100000000000000000001             100000000001      100000000000000000001
        10001000000101000000001            1D11111111D1     10000000000000000000001
       1000010000010001000000001     111111101    10001    1000000000000000000000001
      100000100000011100000000001    10D0011D1    1011    100000000000000000000000001
     10000001000000000000000000001   10110D001   1001    10000000000000000000000000001
    1000000010000000000000000000001  101 1111   1001    1000000000000000000000000000001
   100000000100000111111110000000001 101        101    100000000000000111111110000000001
 11000111111100001        10000000001101        101   1000000000000001        10000000001
10000100000000001          10000000001D1        101111000000000000001          10000000001
1000100000010001            100000000001        10000D000000000000001           1000000001
 1000110111000001            10000000011        111111000000000000001            100000001
  1000000000000001            10000001                1000000000000001            10000001
   10000000000000011111111    1000001                  10000000000000011111111    1000001
    10000000000000000000001    11111                    10000000000000000000001    11111
     100000000000000000000011  1                         100000000000000000000011  1
      10000000000000000000001  1                          10000000000000000000001  1
       1000000000000000000001  1                           1000000000000000000001  1
        100000000000000000001  1                            100000000000000000001 1
         1000000000000000001   1                             1000000000000000001   1
          10000000000000001   1                               10000000000000001   1
           100000000000001    1                                100000000000001    1
            1000000000001    1                                  1000000000001    1
             10000000001    1                                    10000000001    1
              100000001    1                                      100000001    1
               1000001                                             1000001
                10001                                               10001
                 101                                                 111
                  1                                                   1