NO bonus//textures/north.xpm
SO bonus//textures/south.xpm
WE bonus//textures/west.xpm
EA bonus//textures/east.xpm

F 175,122,197
C 160,232,255 

111111111
110001101
1001D1111
1D10EDDX1
101011111
111111111