NO bonus//textures/north.xpm
SO bonus//textures/south.xpm
WE bonus//textures/west.xpm
EA bonus//textures/east.xpm

F 175,122,197
C 160,232,255 

111111
100001
101D11
10DN01
101001
111111
