NO bonus//textures/north.xpm
SO bonus//textures/south.xpm
WE bonus//textures/west.xpm
EA bonus//textures/east.xpm


F 175,122,197
C 160,232,255 

1111111111111111111111111111111111111111
1N00000001111110000000111110000000000001
1000000001100000001100000001100000000001
1000000000000000001100000001100000000001
1000000001100000001100000001100000000001
1000000001101111111100000001100000000001
1000000001100000001100000001100000000001
1000000000000000001100000000000000000001
1000000001100000001100000001100000000001       11
100000000110000000110000000110000000000111     10
100000000110111100110000000110000000001 101    11
1000000001100000001100000001100000000001111
1000000001100000001100000001100000000001
1000000001100000001100000001100000000001
1000000001100000001100000000000000000001
1000000001101111111100000001100000000001
1000000001100000001100000001100000000001
1000000001100000000000000001100000000001
1000000001100000001100000001100000000001
1111111111111111111111111111111111111111
