NO bonus//textures/north.xpm
SO bonus//textures/south.xpm
WE bonus//textures/west.xpm
EA bonus//textures/east.xpm


F 175,122,197
C 160,232,255 

111111111
100000001
10001D1001
100000001
100000001
100000001
100000001
10000N001
111111111
